#Table name
data

#Input column name	Output column name
prod_name	Titre
prod_url	URL_Produit
rrp	Prix_de_base
price	Prix
brand_name	Marque
detail_desc	Description
image_url	URL_Image
ean	EAN
category	Catégorie_de_produits
sub_category	Sous_catégorie
delivery_time	Délais_de_livraison
delivery_cost	Frais de livraison
availability	Etat_du_stock
warranty	Garantie
mpn	MPN
sku	SKU
sku	ShopOfferId_unique
