#Table name
data

#Input column name	Output column name
google_ref_id	id
prod_name	title
detail_desc	description
google_product_category	google_product_category
product_type	product_type
product_url	link
image_url	image_link
condition	condition
availability	availability
price_w_curr	price
price_w_curr	sale_price
brand_name	brand
mpn	mpn
upc	upc
item_group_id	item_group_id
colour_name	color
shipping	shipping
prod_weight	shipping_weight