#Table name
data

#Input column name	Output column name
prod_name	Product Name
mpn	MPN
upc	UPC
sku	SKU
price	Price
cat_name	Category Name
brand_name	Brand Name
detail_desc	Short Description
image_url	Image Link
product_url	Product URL
shipment_cost	Shipment Costs
stock_status	Stock Status
condition	Condition
payment_type	Payment Type
promo_msg	Promotional Message
currency	Currency
availability	Availability
model	Model
prod_id	Product ID
