#Table name
data

#Input column name	Output column name
prod_name	title
prod_url	product-url
price	price
rrp	price-no-rebate
brand_name	brand
detail_desc	description
image_url	image-url
ean	ean
category	merchant-category
availability	availability
delivery_cost	delivery-cost
delivery_time	delivery-time
condition	condition
empty_field	ecotax
warranty	warranty
empty_field	mobile-url
mpn	mpn
sku	sku